+----+----+----+----+----+----+----+----+----+----+----+----+----+----+----+----+
|         |              |    |                        |         |    |         |
+----+    +----+----+    +    +    +----+    +    +    +----+    +    +    +----+
|    |    |         |    |         |         |    |              |              |
+    +    +    +    +    +----+----+----+----+    +----+----+----+----+----+    +
|    |         |    |    |                        |                        |    |
+    +    +----+    +    +    +----+----+    +----+    +----+----+----+    +    +
|         |         |    |    |              |         |                   |    |
+----+----+    +    +    +    +    +----+----+    +----+    +----+----+----+    +
|              |         |    |         |    |         |    |         |         |
+    +----+----+----+----+    +----+    +    +----+    +----+    +    +    +    +
|    |         |              |         |         |              |    |    |    |
+    +    +    +    +----+----+    +    +    +    +----+----+----+    +    +    +
|         |         |         |    |         |                   |    |    |    |
+----+    +----+----+----+    +----+----+----+    +----+----+    +    +    +    +
|    |                   |         |         |    |         |         |    |    |
+    +----+----+----+    +----+    +    +    +    +    +    +----+----+    +    +
|    |              |         |    |         |    |    |    |         |    |    |
+    +    +----+    +----+    +    +----+    +    +    +----+    +    +    +    +
|         |    |         |    |    |              |              |         |    |
+    +----+    +    +    +    +    +----+----+----+----+----+----+    +    +    +
|              |    |         |                        |    |         |    |    |
+----+    +----+    +----+----+    +----+----+    +    +    +    +----+    +    +
|         |         |         |    |              |         |    |         |    |
+    +----+    +    +----+    +    +    +----+----+----+    +    +----+----+    +
|         |    |              |    |         |    |         |              |    |
+----+    +    +----+----+----+----+----+    +    +    +----+----+----+    +    +
|         |    |                   |         |    |    |              |    |    |
+    +----+    +    +----+----+    +    +----+    +    +----+    +    +    +    +
|    |         |              |    |    |         |    |         |         |    |
+    +    +    +----+----+----+    +    +    +    +    +    +----+----+----+    +
|    |    |                                  |    |         |                   |
+----+----+----+----+----+----+----+----+----+----+----+----+----+----+----+----+