+----+----+----+----+----+----+----+----+----+----+----+----+----+----+----+----+
|                   |                             |         |              |    |
+----+----+----+    +    +----+----+----+----+    +    +    +    +----+    +    +
|              |         |         |         |         |    |         |         |
+    +----+    +----+----+    +    +    +    +    +----+    +----+    +----+----+
|    |    |    |    |         |         |         |         |    |              |
+    +    +    +    +    +    +----+----+----+----+    +----+    +----+----+    +
|         |    |         |              |              |              |         |
+----+----+    +----+----+----+----+    +    +----+----+    +----+    +    +----+
|         |    |         |    |         |                   |         |         |
+    +----+    +    +    +    +    +----+----+----+----+----+    +----+----+    +
|         |         |    |         |         |         |         |         |    |
+----+    +----+    +    +    +----+    +    +----+    +    +    +    +    +    +
|    |              |         |         |              |    |         |    |    |
+    +----+    +----+----+----+    +----+----+----+----+    +----+----+    +    +
|         |         |         |    |         |              |                   |
+    +    +----+    +----+    +    +         +    +----+----+    +----+----+    +
|    |    |                   |    |         |              |    |         |    |
+    +----+    +    +----+----+    +    +----+----+----+----+    +    +    +    +
|              |    |         |    |                             |    |    |    |
+----+----+----+    +    +    +    +----+    +----+----+----+----+    +    +----+
|                   |    |         |         |         |              |         |
+    +----+----+----+    +----+----+    +----+    +----+    +----+----+----+    +
|         |         |    |                   |                   |         |    |
+----+    +    +    +    +----+----+    +    +----+----+    +----+    +    +    +
|         |    |    |         |    |    |    |              |         |         |
+    +----+----+    +----+    +    +    +    +----+    +----+    +----+----+----+
|                   |    |    |    |    |    |              |         |         |
+----+----+----+----+    +    +    +    +    +    +----+----+----+    +    +    +
|         |         |    |              |         |                   |    |    |
+    +    +    +    +    +----+----+----+----+----+    +----+    +----+    +    +
|    |         |                                       |                   |    |
+----+----+----+----+----+----+----+----+----+----+----+----+----+----+----+----+