+----+----+----+----+----+----+----+----+----+----+----+----+----+----+----+----+
|         |                                       |                        |    |
+----+    +----+----+    +----+----+----+    +    +    +----+    +----+    +    +
|    |         |    |         |         |    |    |         |    |         |    |
+    +----+    +    +----+    +    +    +----+    +----+----+    +    +    +    +
|              |         |    |    |         |                   |    |    |    |
+----+    +----+----+    +    +----+----+    +----+----+----+----+----+    +    +
|         |              |         |    |    |    |                        |    |
+    +----+    +----+    +----+    +    +    +    +    +----+----+----+----+    +
|         |    |    |              |    |    |         |                   |    |
+----+    +    +    +----+    +----+    +    +----+----+----+----+    +    +    +
|         |    |                        |         |              |    |    |    |
+    +----+    +----+    +----+----+----+----+    +    +----+    +    +    +    +
|                   |                        |         |    |    |    |         |
+----+----+----+    +----+----+----+----+    +----+----+    +    +----+    +----+
|              |              |         |    |              |         |         |
+    +----+    +----+----+    +    +    +    +    +    +----+----+    +----+    +
|         |         |              |    |         |    |         |         |    |
+    +    +----+    +    +    +----+----+    +----+    +    +    +----+    +    +
|    |    |         |    |    |    |         |         |    |         |         |
+    +    +----+----+    +----+    +    +----+    +----+----+----+    +----+    +
|    |                   |         |         |         |                        |
+    +----+----+----+----+    +----+----+    +----+    +    +----+----+----+    +
|    |                        |    |         |    |    |              |    |    |
+    +----+----+----+----+    +    +    +----+    +    +----+----+    +    +    +
|         |              |    |    |         |    |                   |         |
+----+    +----+    +    +    +    +----+    +    +----+----+    +----+----+----+
|    |              |         |    |              |              |              |
+    +----+----+----+----+    +    +    +    +----+    +    +    +    +----+    +
|         |         |         |    |    |    |    |    |    |    |    |    |    |
+----+    +    +----+    +    +    +----+    +    +    +    +    +    +    +    +
|                        |    |              |         |    |         |         |
+----+----+----+----+----+----+----+----+----+----+----+----+----+----+----+----+