*************************************************
*     *     *     *        *              *     *
****  *  *  ****  *  ****  *  **********  *  *  *
*     *  *           *     *  *        *  *  *  *
*  ****  *******************  *  ****  *  *  *  *
*     *     *     *        *  *     *        *  *
****  *  *  *  ****  *  ****  ****  **********  *
*  *  *  *     *     *  *     *  *  *     *     *
*  *  *  *  *  *  ****  *  ****  *  *  ****  ****
*  *     *  *     *        *     *  *     *     *
*  ****************  *  ****  ****  *  *  ****  *
*        *           *     *     *  *  *  *     *
*******  *  *************  *  *  *  ****  *  *  *
*     *     *     *        *  *        *  *  *  *
****  *******  ****  *******  *******  *  *  *  *
*           *        *     *  *        *     *  *
*  *  ****  ****  ****     *******  **********  *
*  *  *           *  *        *     *           *
****  *******  ****  *******  *   ***  ****  ****
*     *     *  *  *        *        *  *        *
*  ****  *  *  *  ****  ****************  ****  *
*  *     *  *     *  *  *  *           *     *  *
*  *  ****  *******  *  *  *  *******  ****  *  *
*     *     *     *     *     *              *  *
*  **********  *  **********  *  *************  *
*              *     *        *  *        *     *
*******************  *  *******  *  ****  *  ****
*                    *     *  *     *     *  *  *
*  ****************  ****  *  *******  ****  *  *
*  *     *     *     *     *     *        *     *
*  *  *  *  *  *******  *******  *  ****  *  ****
*  *  *     *                 *     *     *     *
*************************************************
