+----+----+----+----+----+----+----+----+----+----+----+----+----+----+----+----+
|              |              |         |                        |              |
+    +----+    +    +----+    +----+    +    +----+----+----+    +    +----+    +
|         |    |         |         |    |    |              |              |    |
+----+    +    +----+    +----+    +    +    +    +----+----+----+    +----+    +
|         |         |    |         |    |    |    |         |         |         |
+    +----+----+    +    +    +----+    +    +    +    +    +----+    +    +----+
|              |    |    |    |         |         |    |         |    |    |    |
+----+----+    +----+    +    +    +----+----+----+    +----+    +----+    +    +
|              |         |                        |         |                   |
+    +----+----+    +----+----+    +----+----+    +----+    +----+----+----+----+
|    |              |         |    |         |         |    |         |         |
+    +    +----+----+----+    +    +    +    +----+    +    +    +    +    +    +
|    |    |                        |    |         |    |    |    |         |    |
+    +    +    +----+    +----+----+    +----+    +    +    +----+----+----+    +
|    |    |    |         |         |         |                   |         |    |
+    +    +    +    +    +    +----+    +    +----+----+----+    +    +    +    +
|         |    |    |    |         |         |                   |    |    |    |
+----+----+    +    +----+----+    +----+----+----+    +----+----+    +    +    +
|              |    |              |                                  |         |
+    +----+----+    +    +----+----+----+----+----+----+----+    +----+----+    +
|         |    |    |                                       |    |              |
+----+    +    +    +----+----+----+----+----+----+----+    +    +    +----+----+
|    |         |         |              |         |         |    |              |
+    +----+----+----+    +    +    +    +----+    +    +----+    +----+----+    +
|                   |         |    |              |    |         |         |    |
+----+----+----+    +----+----+----+----+    +----+    +----+----+    +    +    +
|                        |         |              |         |         |    |    |
+    +----+----+    +    +    +    +----+----+    +----+    +    +----+    +    +
|              |    |    |    |                             |    |         |    |
+----+----+    +    +    +    +----+----+----+    +    +----+    +    +----+    +
|              |    |         |                   |              |              |
+----+----+----+----+----+----+----+----+----+----+----+----+----+----+----+----+