+----+----+----+----+----+----+----+----+----+----+----+----+----+----+----+----+
|    |                   |              |              |         |              |
+    +    +----+----+    +    +----+    +    +----+    +    +    +    +----+    +
|    |    |    |         |         |    |    |         |    |         |         |
+    +    +    +    +----+----+    +    +    +    +----+    +    +----+    +    +
|         |         |              |    |    |    |         |         |    |    |
+    +----+    +----+    +----+    +    +----+    +    +----+----+----+    +----+
|         |         |    |         |    |         |    |              |         |
+    +    +----+----+    +----+----+    +    +----+    +----+----+    +    +    +
|    |                   |              |    |         |         |         |    |
+    +----+----+----+----+    +----+----+    +    +    +    +    +----+----+----+
|              |         |                   |    |         |    |              |
+----+----+    +    +    +----+----+    +----+----+----+----+    +----+----+    +
|    |         |    |    |         |    |              |         |         |    |
+    +    +----+    +    +    +    +    +----+    +----+    +----+    +    +    +
|    |         |    |    |    |    |         |    |         |         |    |    |
+    +----+    +    +    +    +    +    +    +    +    +----+    +----+    +    +
|    |    |         |         |    |         |                   |         |    |
+    +    +----+    +----+    +    +----+----+----+    +----+----+    +    +    +
|    |         |         |    |              |    |    |              |    |    |
+    +    +    +----+    +    +----+    +----+    +    +    +----+----+----+    +
|    |    |    |         |    |         |              |         |    |         |
+    +    +    +----+----+    +    +----+----+----+----+    +    +    +    +----+
|         |                   |         |              |    |         |         |
+----+----+----+----+----+----+----+    +    +----+    +    +----+----+----+    +
|         |                             |    |    |    |    |              |    |
+    +    +    +----+----+----+----+----+    +    +    +    +    +----+----+    +
|    |    |                                  |              |         |         |
+    +----+----+----+    +----+----+    +    +----+----+----+----+    +    +----+
|                   |         |    |    |    |                   |    |         |
+    +----+----+    +----+    +    +    +    +    +----+----+    +    +----+    +
|    |                        |         |         |                             |
+----+----+----+----+----+----+----+----+----+----+----+----+----+----+----+----+