+----+----+----+----+----+----+----+----+----+----+----+----+----+----+----+----+
|                                       |         |         |                   |
+    +----+    +----+----+----+----+    +----+    +    +    +    +----+----+----+
|    |    |    |              |                   |    |    |                   |
+    +    +    +    +----+    +----+----+----+----+    +    +----+----+----+    +
|    |         |         |    |         |              |         |              |
+    +----+----+----+    +    +    +    +    +----+----+----+    +    +----+----+
|    |         |         |    |    |    |         |              |         |    |
+    +    +    +----+----+    +    +    +    +    +----+    +----+----+    +    +
|    |    |              |    |    |    |    |    |                   |    |    |
+    +    +----+----+    +    +    +    +    +----+    +----+----+    +    +    +
|         |    |              |    |    |         |    |         |         |    |
+----+----+    +    +    +----+    +    +----+    +    +----+    +----+----+    +
|         |         |         |    |              |         |    |         |    |
+    +----+    +----+----+    +    +----+----+----+----+    +    +    +    +    +
|         |    |                   |              |              |    |         |
+----+    +    +    +----+----+----+    +    +    +    +----+----+    +----+    +
|              |                   |         |    |    |              |         |
+    +----+----+    +----+----+----+----+----+    +    +    +----+----+    +----+
|    |         |    |              |         |         |    |              |    |
+    +    +    +    +    +----+    +    +    +----+----+    +    +----+----+    +
|    |    |    |         |         |    |         |    |    |         |         |
+----+    +----+----+----+    +----+    +----+    +    +    +    +    +    +----+
|         |         |         |         |    |              |    |         |    |
+    +    +    +    +    +----+    +    +    +    +    +----+----+----+    +    +
|    |         |    |              |    |         |              |         |    |
+    +----+----+    +----+    +----+    +----+----+----+----+    +    +----+    +
|    |         |              |              |              |    |         |    |
+    +    +    +----+----+----+----+    +    +    +----+    +    +----+----+    +
|    |    |              |         |    |    |         |         |              |
+    +    +----+    +    +----+    +    +----+----+    +----+----+    +----+----+
|    |    |         |                             |                             |
+----+----+----+----+----+----+----+----+----+----+----+----+----+----+----+----+